date,regularite,trains_programmes,trains_circules,trains_annules,trains_retard
2014-01,91.448,8424,8382,42,796
2014-02,88.50399999999999,7604,7541,63,846
2014-03,91.28235294117647,8413,8377,36,781
2014-04,90.552,8254,8221,33,809
2014-05,91.27799999999999,8371,8326,45,750
2014-06,84.60600000000001,6388,6363,25,1041
2014-07,84.66242145462164,8624,8382,242,1332
2014-08,89.19506971031731,8321,8255,66,845
2014-09,89.32288183847913,8178,8093,85,961
2014-10,84.82324576879826,8715,8639,76,1376
2014-11,86.89310845028426,7597,7532,65,1073
2014-12,84.9308739029711,7899,7776,123,1205
2015-01,89.91947505138991,7361,7262,99,777
2015-02,89.4509040240616,6698,6582,116,746
2015-03,91.69509047679765,7442,7380,62,695
2015-04,88.2711410837077,7094,7000,94,730
2015-05,91.24512002970428,7216,7188,28,652
2015-06,83.27841822280901,7340,7280,60,1021
2015-07,82.53804620654073,7384,7293,91,1177
2015-08,87.5100433033857,7444,7384,60,946
2015-09,88.91929129445045,7548,7465,83,847
2015-10,83.62804829830158,7493,7435,58,976
2015-11,81.12224570178698,7071,6978,93,1171
2015-12,89.52484324447234,7670,7570,100,814
2016-01,89.42604311761643,7465,7380,85,789
2016-02,90.43272542581268,7220,7140,80,723
2016-03,87.18551060676386,7062,6992,70,925
2016-04,88.7513887910558,7338,7275,63,903
2016-05,84.2493536225796,6914,6838,76,1139
2016-06,76.82974758058455,4404,4348,56,1056
2016-07,84.27248079063249,8422,8334,88,1304
2016-08,86.6147395710664,8308,8221,87,1160
2016-09,86.40016121480154,8787,8694,93,1103
2016-10,81.73902516088671,8552,8488,64,1093
2016-11,71.0809215613503,8076,7936,140,1694
2016-12,82.0837277525704,8749,8671,78,1294
2017-01,81.88336248510772,8998,8894,104,1346
2017-02,85.30958877908039,7986,7918,68,956
2017-03,85.92221778503527,8926,8848,78,987
2017-04,87.35631530746114,8456,8383,73,1025
2017-05,80.07262301816843,8310,8229,81,1121
2017-06,73.05273334843312,8274,8181,93,1544
2017-07,74.07091750330028,8595,8508,87,1456
2017-08,76.38472107520695,8828,8751,77,1215
2017-09,78.40116391302944,8310,8225,85,1127
2017-10,76.02916601137429,8493,8418,75,1260
2017-11,72.86998827404325,8333,8215,118,1409
2017-12,75.90945763044938,6943,6820,123,1099
2018-01,86.18968533965817,6467,6289,178,862
2018-02,76.76688688034514,5668,5475,193,1107
2018-03,86.6496511647404,6353,6255,98,778
2018-04,85.5896695931837,3398,3372,26,641
2018-05,80.89116510812032,3747,3685,62,689
2018-06,80.41552815533096,4584,4530,54,994
2018-07,80.4580914304264,6011,5896,115,1197
2018-08,87.12351338857016,6402,6305,97,849
2018-09,88.34690950677793,6245,6178,67,828
2018-10,85.34049423780424,6277,6151,126,967
2018-11,74.97254912148247,7225,7117,108,1776
2018-12,86.32760685733793,6227,6115,112,903
2019-01,89.36816118744291,5062,4963,99,552
2019-02,86.83240242030027,4560,4511,49,409
2019-03,89.21037913317788,4933,4871,62,528
2019-04,86.00951461268039,4949,4902,47,457
2019-05,84.99526894132299,5078,5021,57,542
2019-06,78.30056885685721,4932,4819,113,876
2019-07,84.58277653058225,5182,5121,61,831
2019-08,87.24744480930387,4590,4542,48,542
2019-09,88.81601801803532,4928,4864,64,550
2019-10,84.50722831589614,5028,4668,360,724
2019-11,83.11976255893092,4694,4585,109,816
2019-12,80.34280546864876,1924,1861,63,401
2020-01,77.85640715067855,1340,1309,31,252
2020-02,85.94691278569599,2087,2037,50,344
2020-03,86.84881836087327,1247,1200,47,201
2020-04,93.33333333333334,120,120,0,8
2020-05,79.77104424722056,507,499,8,99
2020-06,83.53783040974623,1189,1167,22,204
2020-07,82.35047296082399,2047,2016,31,387
2020-08,82.03000587187212,2165,2135,30,379
2020-09,80.12315562233994,2034,1968,66,324
2020-10,74.69911000808868,1960,1871,89,400
2020-11,78.99580935063723,688,667,21,95
2020-12,84.28999640750595,1401,1367,34,264
2021-01,75.40920412023614,1899,1855,44,251
2021-02,70.80467935492108,1706,1668,38,273
2021-03,76.32070182140212,1708,1686,22,203
2021-04,64.07176667361345,1145,1139,6,139
2021-05,83.5019431436532,1709,1687,22,224
2021-06,84.61628555583016,1904,1870,34,256
2021-07,80.56610309689218,2297,2253,44,350
2021-08,83.2920026574974,2427,2388,39,317
2021-09,85.99333329521346,2226,2187,39,255
2021-10,78.83472463901751,2271,2242,29,389
2021-11,80.5949059180903,2020,1989,31,304
2021-12,83.92177205014409,2313,2247,66,321
2022-01,84.2240836560659,2025,2001,24,320
2022-02,88.99440007153973,2020,2012,8,233
2022-03,90.45863128590973,2364,2340,24,251
2022-04,88.44141075612035,2132,2109,23,272
2022-05,88.1817383885889,2264,2244,20,332
2022-06,81.80030074608234,2380,2340,40,453
2022-07,75.57464733079641,2406,2362,44,633
2022-08,80.09882605334856,2553,2524,29,475
2022-09,84.87078381860965,2348,2313,35,352
2022-10,85.10607512997692,2220,2210,10,329
2022-11,72.47596921450389,1854,1825,29,311
2022-12,66.11302435343156,1766,1724,42,379
2023-01,68.83625448317142,2017,2005,12,286
2023-02,66.92309711297037,1853,1841,12,319
2023-03,66.89210386984136,1211,1204,7,203
2023-04,75.71365091321186,1854,1832,22,292
2023-05,79.74106426330772,2274,2261,13,439
2023-06,79.16418352468101,2560,2533,27,521
2023-07,84.90709334203393,2585,2563,22,413
2023-08,84.05228412818873,2652,2632,20,426
2023-09,84.8244091544358,2471,2451,20,397
2023-10,80.83971802722468,2482,2449,33,492
2023-11,74.01010641336305,2164,2103,61,573
2023-12,79.70723583021602,2179,2133,46,411
2024-01,83.18753641250501,2429,2399,30,372
2024-02,81.97781403743848,2220,2188,32,337
2024-03,84.79178251493138,2280,2265,15,274
2024-04,85.46106760142709,2530,2501,29,373
2024-05,80.24841307579742,2196,2181,15,329
2024-06,80.27691388487222,2432,2410,22,333
2024-07,84.06771947567718,2702,2673,29,457
2024-08,86.5941628702149,2741,2726,15,402
2024-09,85.65066266450756,2575,2560,15,345
2024-10,82.00621991976735,2567,2528,39,400
2024-11,79.9161837459484,2148,2124,24,421
2024-12,86.98896292526528,2482,2470,12,346
2025-01,86.10917993128554,2416,2379,37,364
2025-02,82.40294601307562,2177,2169,8,307
2025-03,86.9362792352951,2496,2483,13,312
2025-04,86.70694097003029,2437,2427,10,349
2025-05,85.19521108533452,2264,2251,13,342
2025-06,79.68527757258946,2455,2391,64,524
2025-07,84.7224115543082,2693,2658,35,436
